r 0,0 1
T: 0,0,0,0,0,0,0,0,0,0,0 0,0,0,0,0,0,0,0,0,0,0 0,0,0,0,0,0,0,0,0,0,0 0,0,0,0,0,0,0,0,0,0,0 0,0,0,0,0,0,0,0,0,0,0 0,0,0,0,1	,0,0,0,0,0,0 0,0,0,0,1,0,0,0,0,0,0 0,0,0,0,1,0,0,0,0,0,0 0,0,0,0,1,0,0,0,0,0,0 0,0,0,0,1,0,0,0,0,0,0 0,0,0,0,1,0,0,0,0,0,0
g 7,10 3
//g 9,10
/b 7,9
/b 8,8
/b 9,7
/b 10,6
/b 3,10
/b 2,9
/b 1,8
b 0,7
x:ff:0
;
r 0,-1 0
T: 0,0,0,0,0,0,0,0,0,0,0 0,1,0,1,0,1,0,1,0,1,0 0,1,0,1,0,1,0,1,0,1,0 0,1,0,1,0,1,0,1,0,1,0 0,1,0,1,0,1,0,1,0,1,0 0,1,0,1,0,1,0,1,0,1,0 0,1,0,1,0,1,0,1,0,1,0 0,1,0,1,0,1,0,1,0,1,0 0,1,0,1,0,1,0,1,0,1,0 0,1,0,1,0,1,0,1,0,1,0 0,0,0,0,0,0,0,0,0,0,0
t 4,0 3 S 0
s 10,10 5
b 8,8
;
r -1,-1 0
T: 0,0,0,0,0,0,0,0,0,0,0 0,0,0,0,0,0,0,0,0,0,0 0,0,0,0,0,0,0,0,0,0,0 0,0,0,0,0,0,0,0,0,0,0 0,0,0,0,0,0,0,0,0,0,0 0,0,0,0,0,0,0,0,0,0,0 0,0,0,0,0,0,0,0,0,0,0 0,0,0,0,0,0,0,0,0,0,0 0,0,0,0,0,0,0,0,0,0,0 0,0,0,0,0,0,0,0,0,0,0 0,0,0,0,0,0,0,0,0,0,0
t 4,0 2 S 0
t 4,10 2 N 0
t 0,6 2 E 0
t 10,6 2 W 1
;
r 0,-2 1
T: 0,0,0,0,0,0,0,0,0,0,0 0,1,1,1,1,1,1,1,1,1,1 0,0,0,0,0,0,0,0,0,0,0 1,1,1,1,1,1,1,1,1,1,0 0,0,0,0,0,0,0,0,0,0,0 0,1,1,1,1,1,1,1,1,1,1 0,0,0,0,0,0,0,0,0,0,0 1,1,1,1,1,1,1,1,1,1,0 0,0,0,0,0,0,0,0,0,0,0 0,1,1,1,1,1,1,1,1,1,1 0,0,0,0,0,0,0,0,0,0,0
s 10,10 121
;
r 1,0 0
T: 0,0,0,0,0,0,0,0,0,0,0 0,1,1,1,1,1,1,1,1,1,0 0,0,0,0,0,0,0,0,0,0,0 0,1,1,1,1,1,1,1,1,1,0 0,0,0,0,0,0,0,0,0,0,0 0,1,1,1,1,1,1,1,1,1,0 0,0,0,0,0,0,0,0,0,0,0 0,1,1,1,1,1,1,1,1,1,0 0,0,0,0,0,0,0,0,0,0,0 0,1,1,1,1,1,1,1,1,1,0 0,0,0,0,0,0,0,0,0,0,0
b 2,2
b 2,3
;
r 0,1 0
T: 0,0,0,0,0,0,0,0,0,0,0 0,1,1,1,1,1,1,1,1,1,0 0,0,0,0,0,0,0,0,0,0,0 0,1,1,1,1,1,1,1,1,1,0 0,0,0,0,0,0,0,0,0,0,0 0,1,1,1,1,1,1,1,1,1,0 0,0,0,0,0,0,0,0,0,0,0 0,1,1,1,1,1,1,1,1,1,0 0,0,0,0,0,0,0,0,0,0,0 0,1,1,1,1,1,1,1,1,1,0 0,0,0,0,0,0,0,0,0,0,0
b 2,2
b 2,3
;
r -1,0 0
T: 0,0,0,0,0,0,0,0,0,0,0 0,1,1,1,1,1,1,1,1,1,0 0,0,0,0,0,0,0,0,0,0,0 0,1,1,1,1,1,1,1,1,1,0 0,0,0,0,0,0,0,0,0,0,0 0,1,1,1,1,1,1,1,1,1,0 0,0,0,0,0,0,0,0,0,0,0 0,1,1,1,1,1,1,1,1,1,0 0,0,0,0,0,0,0,0,0,0,0 0,1,1,1,1,1,1,1,1,1,0 0,0,0,0,0,0,0,0,0,0,0
b 2,2
b 2,3
;
